XXXXXXXXXXXXXXX
XP-X-----X----G
X--X-----X-XXXX
X--X--X--X-X---
X-----X--X-X---
X-----X----X---
XXXXXXXXXXXX---