XXXXXXXXXXXX---
X----XXX---X---
X--X--X--X-XXXX
X--X-X-X-X-----
XP-X-----X-XXXX
XXXXXXXXXXXX---